####################################
#   #   #  #   #             #@@@@@#
#   #   #                    #@@@@@#
## ### ##@ #   ############# #@@@@@#
#   #   @  #####@@@@@@@@@@@# #@@@@@#
#   #      #   #@@@@@@@@@@@# #@@@@@#
#   #@@    #   #@@@@@@@@@@@# #@@@@@#
#   #   @  #   #@@@@@@@@@@@# #@@@@@#
## ########## ############## #######
#   #      #   #    #@@@@@@# #@@@@@#
#     @  @          #@@@@@@# #@@@@@#
#   #      #   #    #@@@@@@# #@@@@@#
## ########## ############## #######
#     # @@ #   #   @ @ @ @     #   #
#@   @#    #                       #
#     #@  @#   #   @ @ @ @     #   #
#@   @#    #   #####################
#     ##  ##   #    #              #
#     #    #      # #     #### #####
# @@@      #   #### ##### #        #
#     #    #   #          #  # #   #
####################################