####################################
#            #  #  #@@@#   #@@@#   #
#            #  #  ###### ######   #
#   ### ###  @  #              #   #
#   #     #     #                  #
#   # @@@ #     #  ###### ######   #
#   #     #  @  #  #   #   #@@@#   #
#   #######  #  #  #   # # #@@@#   #
#     #@@@#  #  #  ## ## # #@@@#   #
#     #@@@#  #  #  #   #   #@@@#   #
#   ###@@@#  #  @  #@ @# # #@@@#   #
#   #@@@@@#  #     #@ @# # #@@@#   #
#   #######  #     #   #   #@@@#   #
#         #  #  @  ## ### ##@@@#   #
#      @  #  #  #  #       #@@@#   #
#@@@@  @@ ########### ##########   #
#   @     #         # #   #        #
#         #  @####  # # @ #    #####
## #### ###      #      @ #    #   #
#   #     #  @####  # # @ #        #
#   #     #         # #   #    #   #
####################################