                          #######   
   #######     #######    #     #   
   #     #     #     #    #     #   
   # @@@ # #####     ######## ###   
   #     ###              #     #   
   # @@@      ##  #  ##   #     #   
   #     ###  ##  #  ##         #   
   # @@@ # #             @#     #   
   #     # #  ##  #  ##@@ #######   
   #@@ @@# #  ##  #  ##   #@@@  #   
   #     # #      @       #@@@ @#   
   ####### #      @    @@@#@@   #   
           #@ @########         #   
   ######  #   #@@@@@@#   ### ###   
   #    #  #@  #@@@@@@#  @#     #   
   #@@@ ####   #@@@@@@#   #######   
   #           #@@@@@@#@  #         
   #@@@ ####@ @########   #         
   #    #  #   #      #   #         
   ######  #              #         
           #   #      #   #         
           ################         