####################################
#   #   #   #   @      #   #   #   #
#           #      #       #       #
#   #   #   #   @      #   #   #   #
## ####### ### ###### ####### ### ##
#   #   #   #   #  #   #   #   #   #
#       #       #                  #
#   #   #   #   #  #   #   #   #   #
## #################################
#   #       #   #@@#@@@#@@@#@@@#@@@#
#       #       #@@#@@@#@@@#@@@#@@@#
#       #       #@@#@@@#@@@#@@@#@@@#
#   #       #   #@@#@@@#@@@#@@@#@@@#
## ### ####### #####################
#   #   #   #   #      #   #   #   #
#   #   #   #   #                  #
#   #   #   #   #  @   #   #   #   #
###### ### ######  ###### ### ######
#   #   #   #   @  #   #   #   #   #
#                  #       #       #
#   #   #   #      #   #   #   #   #
####################################